15 15 5 60
 +      #######
     D  #!    #
 D      #      
   @   @#  D  @
 +      #      
    #########  
     +        !
 D        D    
    +           
 @     @   @  D
 #####         
 #!   +         
/##         @ @
  #    D       
  #           !